AA	ɑ
AE	æ
AH	ʌ
AO	ɔ
AW 	aʊ
AY	aɪ
B	b
CH	tʃ
D	d	
DH	ð
EH	ɛr
ER	ə
EY	eɪ
F	f
G	ɡ	
HH	h
IH	ɪ
IY	ir
JH	dʒ
K	k	
L   l
M	m
N	n
NG	ŋ
OW	oʊ
OY	ɔɪ
P	p
R	r
S	s
SH	ʃ
T	t
TH	θ
UH	ʊ
UW	u 
W	w
V	v
Y	j
Z	z
ZH	ʒ
